VVVVVVVVVVVVVVVVVVVVVVVVVVVVVVVVVVVVVVVVVVVVVVVVVVVVVVVVVVVVVVVVVVV
                                                    
   WWWWWWWWWWWWWWWWWWWWWWWWWWWWWWWWWWWW                
   WGGGGGGGGGGGGGGGGGGGG#GGGGGGGGGGGGGW                
   WGGGGGGGGGGGGGGGGGGGGGGGGGGGGGGGGGGW                
   WGGGWWWWWWWWWWWWGGGWWWWWWWWWWWWWGGGW               
   WGGGW          WGGGW           WGGGW       
   WGGGW          WGGGW           WGGGW       
   WGGGW          WGGGW           WGGGW       
   WGGGWWWW       WGGGW           WGGGW       
   WGGGGGGW       WGGGWWWWWWWWWWWWWGGGWW      
   WGGGGGCW       WGGGGGGGGGGGGGGGGGGGGW
   WWWWGGGWWWWWWWWWGGGGGGGGGGGGGGGGGGGGW
      WGGGGGGGGGGGGGGWWWWWWWWWWWWWWWWWWW
      WGGGGGGGGGGGGGGW
      WWWWWWWWWWWWWWWW
VVVVVVVVVVVVVVVVVVVVVVVVVVVVVVVVVVVVVVVVVVVVVVVVVVVVVVVVVVVVVVVVVVV