WWWWWWWWWWWWWWWWWWWWWWWWWWWWWWWWWWWWWWWWWWWWWWWWWWWWWWWWWWWWWWWWWWWWWWWWWWWWWWWWWWWWWWWWWWWWWWWWWWWWWWWWWWWWW
WGWGWGWGWGWGWGWGWGWGWGWGWGWGWGWGWGWGWGWGWGWGWGWGWGWGWGWGWGWGWGWGWGWGWGWGWGWGWGWGWGWGWGWGWGWGWGWGWGWGWGWGWGWGW
WGWG#GWGGGGGGGGGGGGGGGGGGGGGGGWGGGGGGGGGGGGGGGGGGGWGGGGGGGGGGGGGGGGGGGGGGGGGGGGGGGGGGGGGGGGGGGGGGGWGGGGGGGWGW
WGWGGGWGGGWGWGWGWGWGWGWGWGWGGGWGGGWGWGWGWGWGGGWGGGWGWGWGWGWGGGWGWGWGWGWGWGWGWGWGWGWGWGWGWGWGWGWGGGWGGGWGGGWGW
WGWGGGWGGGGGGGWGGGWGGGGGGGGGGGWGGGWGGGGGGGGGGGWGGGGGGGGGGGGGGGWGGGGGGGWGGGGGGGGGGGGGGGGGGGWGGGWGGGWGGGWGGGWGW
WGWGGGWGWGWGGGWGGGWGGGWGWGWGWGWGWGWGGGWGWGWGWGWGWGWGWGWGWGWGWGWGGGWGWGWGGGWGWGWGWGWGGGWGGGWGGGWGGGWGGGWGGGWGW
WGWGGGGGGGGGGGWGGGWGGGGGGGGGGGGGGGWGGGWGGGGGGGGGGGWGGGGGGGWGGGGGGGGGGGGGGGWGGGGGGGGGGGWGGGGGGGWGGGWGGGWGGGWGW
WGWGWGWGWGWGWGWGGGWGWGWGWGWGWGWGGGWGGGWGGGWGWGWGGGWGGGWGGGWGWGWGGGWGWGWGWGWGGGWGWGWGWGWGWGWGGGWGGGWGWGWGGGWGW
WGWGGGGGGGGGGGGGGGWGGGGGGGGGGGGGGGWGGGGGGGGGGGWGGGGGGGWGGGGGGGWGGGGGGGWGGGGGGGWGGGGGGGWGGGGGGGWGGGGGGGWGGGWGW
WGWGGGWGWGWGWGWGWGWGGGWGWGWGWGWGWGWGWGWGWGWGWGWGWGWGWGWGWGWGGGWGWGWGWGWGGGWGWGWGGGWGWGWGGGWGWGWGWGWGGGWGGGWGW
WGWGGGGGGGGGGGGGGGGGGGWGGGGGGGWGGGGGGGGGGGGGGGWGGGGGGGGGGGGGGGWGGGGGGGGGGGWGGGGGGGWGGGGGGGWGGGGGGGGGGGWGGGWGW
WGWGGGWGWGWGWGWGWGWGWGWGGGWGGGWGGGWGGGWGWGWGGGWGGGWGWGWGWGWGWGWGGGWGWGWGWGWGGGWGWGWGGGWGWGWGGGWGWGWGWGWGGGWGW
WGWGGGGGGGGGGGGGGGWGGGGGGGWGGGWGGGWGGGWGGGGGGGWGGGWGGGGGGGWGGGGGGGWGGGGGGGGGGGWGGGGGGGGGGGWGGGWGGGGGGGWGGGWGW
WGWGWGWGWGWGWGWGGGWGWGWGGGWGGGWGGGWGGGWGGGWGWGWGGGWGGGWGWGWGGGWGGGWGWGWGWGWGGGWGGGWGWGWGWGWGGGWGGGWGGGWGGGWGW
WGWGGGWGGGGGGGWGGGGGGGGGGGWGGGWGGGWGGGWGGGGGGGGGGGWGGGWGGGGGGGWGGGWGGGGGGGWGGGGGGGWGGGWGGGGGGGWGGGWGGGGGGGWGW
WGWGGGWGGGWGGGWGWGWGWGWGWGWGGGWGWGWGGGWGWGWGWGWGWGWGGGWGGGWGWGWGGGWGGGWGGGWGGGWGWGWGGGWGGGWGWGWGGGWGWGWGGGWGW
WGWGGGGGGGWGGGGGGGGGGGGGGGWGGGGGGGWGGGWGGGGGGGGGGGGGGGGGGGWGGGWGGGGGGGWGGGWGGGGGGGGGGGWGGGWGGGGGGGWGGGWGGGWGW
WGWGGGWGWGWGWGWGWGWGGGWGWGWGWGWGGGWGGGWGGGWGWGWGWGWGWGWGWGWGGGWGWGWGWGWGGGWGWGWGWGWGGGWGGGWGGGWGWGWGGGWGGGWGW
WGWGGGWGGGGGGGGGGGWGGGWGGGGGGGWGGGWGGGWGGGGGGGGGGGGGGGGGGGWGGGGGGGWGGGGGGGWGGGGGGGWGGGWGGGWGGGGGGGWGGGWGGGWGW
WGWGGGWGGGWGWGWGGGWGGGWGGGWGGGWGGGWGGGWGWGWGWGWGWGWGWGWGGGWGWGWGGGWGGGWGWGWGGGWGGGWGWGWGGGWGWGWGGGWGGGWGGGWGW
WGWGGGGGGGWGGGGGGGWGGGGGGGWGGGGGGGGGGGWGGGGGGGGGGGGGGGGGGGGGGGGGGGWGGGGGGGGGGGWGGGGGGGGGGGGGGGGGGGWGGGGGCGWGW
WGWGWGWGWGWGWGWGWGWGWGWGWGWGWGWGWGWGWGWGWGWGWGWGWGWGWGWGWGWGWGWGWGWGWGWGWGWGWGWGWGWGWGWGWGWGWGWGWGWGWGWGWGWGW
WWWWWWWWWWWWWWWWWWWWWWWWWWWWWWWWWWWWWWWWWWWWWWWWWWWWWWWWWWWWWWWWWWWWWWWWWWWWWWWWWWWWWWWWWWWWWWWWWWWWWWWWWWWWW