SSSSSSSSSSSSVVVVVVVVVVVVVVVVVVVVVVVVVVV
SSSSSSSSSSSSSSVVVVVVVVVVVVVVVVVVVVVVVVV
SSSSSSSSSSSSSSSSVVVVVVVVVVVVVVVVVVVVVVV
SSSSSSSSSSSSSSSSSSSSSSSSSSVVVVVVVVVVVVV
VVVVVVVVVVVVVVSSSSSSSSSSSSSSSSSSSSSVVVV
VVVVVVVVVVSSSSSSSSSSSSSSSSSSVVVVVVVVVVV
SSSSSSSSSSSSSSSSSSSSSSSSSSSSSSSSSSSSSSS
SSSSSSSSSSSSSSSSSVVVVVVVVVVVVVVVVVVVVVV
SSSSCSVVVVVVVVVVVVVVVVVVVVVVVVVVVVVVVVV
