VVVVVVVVVVVVVVVVVVVVVVVVVVVVVVVVVVVVVVVVVVVVVV


       WWWWWWWWWWWWWWWW
       WGGGGGGGGGGGGG#W     WWWWWWWWWW
       WGGGGGGGGGGGGGGW   WWWGGGGGGGGW
       WWWWGGWWWWWWWGGWWWWWGGGGGGWWWWW
          WGGW     WGGGGGGGGGGGWWW
          WGGW     WGGGGGGGGWWGW
          WGGWWWWWWWGGWWWGWWWWGW
        WWWGGGGGGGGGGGW WWW  WGW
        WGGGGGGGGGGGGGW      WGW
        WGWWWWWWGWWWWWW      WGW
        WGW    WGW           WCW
        WGW    WGW           WGW
        WGWWWWWWGWWWWWWWWWWWWWGW
        WGGGGGGGGGGGGGGGGGGGGGGW
        WWWWWWWWWWWWWWWWWWWWWWWW
        
        
VVVVVVVVVVVVVVVVVVVVVVVVVVVVVVVVVVVVVVVVVVVVVV
