VVVVVVVVVVVVVVVVVVVVVVVVVVVVVVVVVVVVVVVVVVVVVVVVVVVVVVVVVVVVVVVVVVV
                                                    
                                      
          WWWWWWWWWWWWWWWWWWWWWWWWWWWW              
          WGGGGGGGG#GGGGGGGGGGGGGGGGGW
          WGGGGGGGGGGGGGGGGGGGGGGGGGGW
   WWWWWWWWGWWWWWWWWWGGWWWGGWWWWWWGWWW
   WGGGGGGGGGW      WGGW WGGW    WGW
   WGGGGGGGGGW      WGWWWWWGW    WWW
   WGGWWWWWGGW      WGGGGGGGW   
   WGGW   WGGWWWWWWWWGGGGGGGW         
   WCGWWWWWGGGGGGGGGGGGGGGGWW     
   WGGGGGGGGGGGGGGGGGGGGGGGWW  
   WWWWWWWWGGGGGGGGGGGGGGGGGW
          WWWWWGWWWWWGGWWWWGW
              WWW   WWWW  WWW
          
          
VVVVVVVVVVVVVVVVVVVVVVVVVVVVVVVVVVVVVVVVVVVVVVVVVVVVVVVVVVVVVVVVVVV