                                                    V
                                                    V
                       WWWWWWWWWWWWWW               V
                       WGGGGG#GGGGGGW               V
                       WGGGGGGGGGGGGW               V
                       WWWWWWWWWWWWGW               V
                                  WGW               V
                                  WGW               V
                                  WGW               V
                                  WGW               V
                  WWWWWWWWWWWWWWWWWGWW              V
                  WGGGGGGGGGGGGGGGGGGW
                                  
                    