VVVVVVVVVVVVVVVVVVVVVVVVVVVVVVVVVVVVVVVVVVVVVVVVVVVVVVVVVVVVVVVVVVV
                                                    
                       WWWWWWWWWWWWWW               
                       WGGGGGGGGGGGGW               
                       WGGGGGGGGGGGGW               
                       WWWWWWWWWWWWGW               
                                  WGW               
                                  WGW               
                                  WGW               
                                  WGW               
                  WWWWWWWWWWWWWWWWWGWW              
                  W#GGGGGGGGGGGGGGGGGW
                  WGGGGGGGGGGGGGGGGGGW
                  WWWGWWWWWGWWWWWWGWWW
                    WGW   WGW    WGW
                    WGWWWWWGW    WGW
                    WGGGGGGGW    WGW
          WWWWWWWWWWWGWWWWWGW    WGW     
          WGGGGGGGGGGGW   WWW    WWW  
          WGGGGGGGWWWWW      
          WCGGGWWW
          WWWWWW

VVVVVVVVVVVVVVVVVVVVVVVVVVVVVVVVVVVVVVVVVVVVVVVVVVVVVVVVVVVVVVVVVVV