WWWWWWWWWWWWWVVVVVVVV
WGGGGGGGGGGCW
WGGGGGGGGGGGW
WGGGGGGGGGGGW
W#GGGGGGGGGGW
WWWWWWWWWWWWW


